1111111111
10P00C0C01
100000E001
1111111111