1111111
1P00001
1011101
1C0E0C1
1111111