1111111111
1P000001C1
1011111001
1C000000E1
1110111101
1C00000001
1111111111