11111
1PEC1
10001
10001
10001
11111